||||||||||||||||||||
|p-----------------|
|------------------|
|++++++++++++++++++|
|------------------|
|++++++++++++++++++|
|------------------|
|++++++++++++++++++|
|------------------|
|++++++++++++++++++|
|------------------|
|++++++++++++++++++|
|------------------|
|++++++++++++++++++|
|------------------|
|++++++++++++++++++|
|------------------|
|++++++++++++++++++|
|-----------------g|
||||||||||||||||||||